0010010300
0010011100
0010000100
0011110100
0000000100
1110111100
0010101000
2000101111
0001100000
1100000000