11111111111111111111111111111111111111111111111111
10001000100000000000100000000000000010000000000000
10111010101110111110101111111010101110111111111110
10100010100000100000101000001010100000100010000000
10101110101111101111101011101011111110101010111110
10101000101000101000101000101010000010001010001000
10101011101010101010101110101010111011111011101011
10000000001010001010101000100010001010000010001000
10111111111011111010101011111111101011111110111110
10000010100010000010101010000000001000001000100000
11111000101010111110101011111011111111101011111011
10000000101010000010001000001010001000000010001010
10111111101111111011111111101010101111111010101010
10101000001000000010000000101010101000001010101000
10101011101011111110101111101010101011101010101110
10001010001000100000101000001000101010101010101000
11101011101110101011111011111011101010101110101111
10001000101000101010000010100000101010100000101000
10111100101011101010111110101111101010110111101010
10001000101010001010100000101010001000100010101010
11111011101010111010111011101010111110101010101010
10000010101010100010001000000010001000101000100010
10111110101010111111101111111111101011101110111110
10100000001010100000100000100000001000001000101000
10111111111010101011111110101111101111111011101011
10000010001010001010000010101000000010001010001000
10111010100010111010101011101111111010101011101110
10001000100010001000101010000000100010100010000010
11101110111110111111101011111110111110111110111110
10101000100010103000001010000010100000100000100000
10101010101011101111111010111010101111111110101110
10101010001000001010001010100010101000000000101000
10100011111111111010101010101110101011111110101011
10100010000000100000100010101000101010000010101000
10111110111110101111111110101010101010111011101111
10001000101000100000001000100010000010001000101000
10101011101011111111101011101111111011101110101010
10101010001000001000100010101000100000101000100010
10101010111110101011101110101010101111101211101110
10100010001000100010001000001010101010001000100010
10111111101011101110101011111010101010111110111010
10100000001010101000101000100010100010001000001010
10111110111010101011101110111010111011101111101110
10100010100010001000101000100010001000100010001000
10101010101111101110101011101111101111101010111010
10001010100000100010101000001000100000101010000010
11111010111110111000001111111010111110101011111110
10001010001010001010100000100010100010101010001000
10110010101011101110101111101011101010111010101011
10000000100000100000100000001000001000000010100000
