0000111100
2000000100
0000110100
0000100100
0011100111
0000000000
1100001110
0001011000
0001010000
0001010003