0000001000
1111101111
0000101000
1110101003
0010111010
2010000011
0010110001
0010010101
0011010101
0000010101